------------------------------
-                            -
-                            -
-  P            Z   ---      -
-                   ---      -
-                            -
-       ---           ---    -
-                            -
-  -                         -
-          --                -
-                            -
-   ---                     -
-                            -
-                            -
------------------------------
