------------------------------
-                            -
-                            -
-  P            Z   ---      -
-                   ---      -
-                            -
-       ---           ---    -
-                            -
-  -                         -
-          --    E           -
-                            -
-   ---                      -
-                            -
-   E                        -
------------------------------
