------------------------------
-                            -
-       Z                    -
-  P               ---       -
-                      ---   -
-                    Z        -
-       ---           ---    -
-                            -
-  -                         -
-          --                -
-                            -
-   ---                      -
-                Z            -
-                            -
------------------------------